▼,▼,　,　,　,　,　,　,　
▼,▼,　,水,水,　,　,▼,　
　,　,水,水,水,水,　,　,　
　,　,　,水,水,水,　,　,　
　,▼,　,　,　,　,　,　,　
　,　,　,　,　,　,　,　,　