　,　,　,　,　,　,　,　,　
　,▲,▼,■,○,　,　,　,　
　,　,　,　,　,　,　,　,　
　,　,　,　,　,　,　,　,　
　,　,　,○,■,▼,▲,　,　
　,　,　,　,　,　,　,　,　